#######
#     #
#  @  #
#^    #
#######
