#@#######
#000#000#
#0000000#
#000#000#
#####^###
